{
  "name": "qwerty",
  "desc": "df",
  "layout": [
    [
      { "kc": 59, "h": 1, "w": 1 },
      { "kc": 60, "h": 1, "w": 1 },
      { "kc": 61, "h": 1, "w": 1 },
      { "kc": 62, "h": 1, "w": 1 },
      { "kc": 63, "h": 1, "w": 1 },
      { "kc": 64, "h": 1, "w": 1 },
      { "kc": 65, "h": 1, "w": 1 },
      { "kc": 66, "h": 1, "w": 1 },
      { "kc": 67, "h": 1, "w": 1 },
      { "kc": 68, "h": 1, "w": 1 },
      { "kc": 87, "h": 1, "w": 1 },
      { "kc": 88, "h": 1, "w": 1 }
    ],
    [
      { "kc": 15, "h": 1, "w": 1 },
      { "kc": 16, "h": 1, "w": 1 },
      { "kc": 17, "h": 1, "w": 1 },
      { "kc": 18, "h": 1, "w": 1 },
      { "kc": 19, "h": 1, "w": 1 },
      { "kc": 20, "h": 1, "w": 1 },
      { "kc": 21, "h": 1, "w": 1 },
      { "kc": 22, "h": 1, "w": 1 },
      { "kc": 23, "h": 1, "w": 1 },
      { "kc": 24, "h": 1, "w": 1 },
      { "kc": 25, "h": 1, "w": 1 },
      { "kc": 41, "h": 1, "w": 1 }
    ],
    [
      { "kc": 28, "h": 1, "w": 1 },
      { "kc": 30, "h": 1, "w": 1 },
      { "kc": 31, "h": 1, "w": 1 },
      { "kc": 32, "h": 1, "w": 1 },
      { "kc": 33, "h": 1, "w": 1 },
      { "kc": 34, "h": 1, "w": 1 },
      { "kc": 35, "h": 1, "w": 1 },
      { "kc": 36, "h": 1, "w": 1 },
      { "kc": 37, "h": 1, "w": 1 },
      { "kc": 38, "h": 1, "w": 1 },
      { "kc": 39, "h": 1, "w": 1 },
      { "kc": 40, "h": 1, "w": 1 }
    ],
    [
      { "kc": 42, "h": 1, "w": 1 },
      { "kc": 44, "h": 1, "w": 1 },
      { "kc": 45, "h": 1, "w": 1 },
      { "kc": 46, "h": 1, "w": 1 },
      { "kc": 47, "h": 1, "w": 1 },
      { "kc": 48, "h": 1, "w": 1 },
      { "kc": 49, "h": 1, "w": 1 },
      { "kc": 50, "h": 1, "w": 1 },
      { "kc": 51, "h": 1, "w": 1 },
      { "kc": 52, "h": 1, "w": 1 },
      { "kc": 53, "h": 1, "w": 1 },
      { "kc": 43, "h": 1, "w": 1 }
    ],
    [
      { "kc": 29, "h": 1, "w": 1 },
      { "kc": 56, "h": 1, "w": 1 },
      { "kc": 3675, "h": 1, "w": 1 },
      { "kc": -1, "h": 1, "w": 1 },
      { "kc": 23, "h": 1, "w": 1 },
      { "kc": 57, "h": 1, "w": 1 },
      { "kc": 14, "h": 1, "w": 1 },
      { "kc": 61011, "h": 1, "w": 1 },
      { "kc": -1, "h": 1, "w": 1 },
      { "kc": -1, "h": 1, "w": 1 },
      { "kc": -1, "h": 1, "w": 1 },
      { "kc": 57376, "h": 1, "w": 1 }
    ]
  ]
}
